Xoi, Isr, Isr, Xoi, Xoi, Xoi, Xoi, Xoi, Xoi, Xoi, Xoi, Xoi, Xoi, Xoi
Xoi, Isr, Isr, Xoi, Xoi, Xoi, Xoi, Xoi, Iwc, Iwc, Iwc, Xoi, Xoi, Xoi
Xoi, Isr, Isr^Efs, Xoi, Xoi, Xoi, Isr^Efs, Iwc, Iwc, Iwc, Iwc, Iwc, Iwc, Xoi
Xoi, Isr, Isr, Isr, Isr^Efs, Isr^Efs, Isr, Isr, Isr, Iwc, Iwc, Iwc, Xoi, Xoi
Xoi, Isr, Isr, Isr, Isr, Isr, Isr, Isr, Isr, Isr, Isr^Efs, Xoi, Xoi, Xoi
Xoi, Xoi, Isr^Efs, Isr, Isr, Isr, Isr, Isr, Isr, Isr, Isr, Xoi, Xoi, Xoi
Xoi, Xoi, Xoi, Isr, Isr^Efs, Isr, Isr, Isr, Isr, Isr, Isr^Efs, Xoi, Xoi, Xoi
Xv, Xoi, Xoi, Xoi, Xoi, Isr^Efs, Isr, Isr, Isr, Isr, Isc, Isc, Isc, Xoi
Xv, Xv, Xv, Xoi, Xoi, Xoi, Xoi, Isr^Efs, Xoi, Isc, Isc, Isc, Xoi, Xoi
Xv, Xv, Xv, Xv, Xv, Xoi, Xoi, Xoi, Xoi, Xoi, Xoi, Xoi, Xv, Xv
Xv, Xv, Xv, Xv, Xv, Xv, Xv, Xoi, Xoi, Xoi, Xv, Xv, Xv, Xv
Xv, Xv, Xv, Xv, Xv, Xv, Xv, Xv, Xv, Xv, Xv, Xv, Xv, Xv
