Rr, Gll^Fmf, Gll^Fmf, Gll^Fmf, Gll^Fmf, Gll^Fmf, Gll^Fmf, Gll^Fmf, Gll^Fmf, Gll^Fmf, Gll^Fmf, Gll^Fmf, Gll^Fmf, Gll^Fmf, Gll^Fmf, Gll^Fmf, Gll^Fmf, Gll^Fmf, Gll^Fmf, Gll^Fmf, Gll^Fmf, Gll^Fmf, Gll^Fmf, Gll^Fmf, Gll^Fmf, Gll^Fmf, Gll^Fmf, Gll^Fmf, Gll^Fmf, Gll^Fmf, Rr, Rr, Rr, Gg
Rr, Rr, 1 Rr, Gll^Fmf, Gll^Fmf, Gll^Fmf, Gll^Fmf, Gll^Fmf, Gll^Fmf, Gll^Fmf, Gll^Fmf, Gll^Fmf, Gll^Fmf, Gll^Fmf, Rr, Rr, Rr, Gll^Fmf, Gll^Fmf, Gll^Fmf, Gll^Fmf, Gll^Fmf, Gll^Fmf, Gll^Fmf, Gll^Fmf, Gll^Fmf, Gll^Fmf, Gll^Fmf, Rr, Rr, Rr, Rr, Gll^Fmf, Gg
Gll^Fmf, Rr, Rr, Rr, Rr, Gll^Fmf, Rr, Rr, Rr, Gll^Fmf, Gll^Fmf, Gll^Fmf, Rr, Rr, Rr, Rr, Rr, Rr, Rr, Gll^Fmf, Gll^Fmf, Gll^Fmf, Gll^Fmf, Gll^Fmf, Gll^Fmf, Gll^Fmf, Rr, Rr, Rr, Rr, Gll^Fmf, Gll^Fmf, Gll^Fmf, Gll^Fmf
Gll^Fmf, Gll^Fmf, Gll^Fmf, Rr, Rr, Rr, Rr, Rr, Rr^Cov, Rr, Rr, Rr, Rr, Rr, Gll^Fmf, Gll^Fmf, Gll^Fmf, Rr, Rr, Rr, Rr, Gll^Fmf, Gll^Fmf, Gll^Fmf, Rr, Rr, Rr, Rr, Gll^Fmf, Gll^Fmf, Gll^Fmf, Gll^Fmf, Gll^Fmf, Gll^Fmf
Gll^Fmf, Gll^Fmf, Gll^Fmf, Gll^Fmf, Gs, Rr, Rr, Rr^Cov, Rr^Kov, Rr^Cov, Rr, Rr, Gs, Gs, Gll^Fmf, Gll^Fmf, Gll^Fmf, Gll^Fmf, Gll^Fmf, Rr, Rr, Rr, Rr, Rr, Rr, Rr, Gll^Fmf, Gll^Fmf, Gll^Fmf, Gll^Fmf, Gll^Fmf, Gll^Fmf, Gll^Fmf, Gll^Fmf
Gll^Fmf, Gll^Fmf, Gll^Fmf, Gll^Fmf, Gs, Rr, Rr, Rr^Cov, Rr^Cov, Rr^Cov, Rr, Rr, Rr, Gs, Gs, Gll^Fmf, Gll^Fmf, Gll^Fmf, Gll^Fmf, Gll^Fmf, Gll^Fmf, Rr, Rr, Rr, Rr, Rr, Rr, Gll^Fmf, Gll^Fmf, Gll^Fmf, Gll^Fmf, Gll^Fmf, Gll^Fmf, Gll^Fmf
Gll^Fmf, Gll^Fmf, Gll^Fmf, Gll^Fmf, Gs, Rr, Rr, Rr, Rr, Rr, Rr, Rr, Rr, Rr^Kov, Rr^Cov, Gs, Gs, Gll^Fmf, Gll^Fmf, Gll^Fmf, Gll^Fmf, Gll^Fmf, Gll^Fmf, Gll^Fmf, Gll^Fmf, Rr, Rr, Gll^Fmf, Gll^Fmf, Gll^Fmf, Gll^Fmf, Gll^Fmf, Gll^Fmf, Gll^Fmf
Gll^Fmf, Gll^Fmf, Gs, Gll^Fmf, Gs, Rr, Rr, Rr, Rr, Rr, Rr, Rr, Rr, Rr, Rr, Gs, Gs, Gs, Gs, Gll^Fmf, Gll^Fmf, Gll^Fmf, Gll^Fmf, Gll^Fmf, Gll^Fmf, Rr, Rr, Rr, Gll, Gll^Fmf, Gll^Fmf, Gll^Fmf, Gll^Fmf, Gll^Fmf
Gg, Gs, Gs, Gs, Gs, Rr^Vhc, Gs, Rr, Rr, Rr, Rr, Rr, Rr, Rr, Gs, Rr^Vhc, Gs, Gs, Gs, Gg, Gg, Gll^Fmf, Gg, Gll^Fmf, Gg, Rr, Rr, Rr, Rr, Gll^Fmf, Gll^Fmf, Gll^Fmf, Gll^Fmf, Gll^Fmf
Gs, Gs, Gs^Efm, Gs, Gs, Gs, Gs, Rr^Vhc, Gs, Rr, Rr, Rr, Rr^Vhc, Gs, Gs, Gs, Gs, Gs, Gg^Eff, Gg^Eff, Rb^Eff, Gg, Gg, Gg, Gs^Vh, Gg, Rr, Rr, Rr, Gll, Gll, Gll^Fmf, Gll^Fmf, Gg
Gs, Gs^Efm, Gs^Efm, Gs^Efm, Gs^Efm, Gs, Gs, Gs, Gs, Rr^Vhc, Gs, Gs, Gs, Gs, Gs, Gs, Gg^Eff, Gg^Eff, Rb^Gvs, Rb^Gvs, Rb^Gvs, Rb^Eff, Rb^Eff, Gg, Gg, Gg^Efm, Rr, Rr, Rr, Gll, Gll^Fmf, Gll^Fmf, Gll^Fmf, Gg
Gs, Gs^Efm, Gs^Efm, Gs^Efm, Gs^Efm, Gs^Efm, Gs, Gs, Gs, Gs, Gs, Gs, Gs, Gs, Gg^Eff, Gg^Eff, Rb^Gvs, Rb^Gvs, Rb^Gvs, Rb^Gvs, Rb^Gvs, Rb^Gvs, Rb^Gvs, Rb^Eff, Rb^Eff, Gg, Rr, Rr, Rr, Gll, Gll^Fmf, Gll^Fmf, Gll^Fmf, Gg
Gg, Gs, Gs, Gs^Efm, Gs, Gs, Gs, Gs, Gg, Gg, Gg, Gs, Gg^Eff, Gg^Eff, Rb^Gvs, Rb^Gvs, Rb^Gvs, Rb^Gvs, Rb^Gvs, Rb^Gvs, Rb^Gvs, Rb^Gvs, Rb^Gvs, Rb^Gvs, Gg^Eff, Gg^Eff, Rr, Rr, Rr, Gll^Fmf, Gll^Fmf, Gll^Fmf, Gll^Fmf, Gg
Gg, Gg, Gg, Gs, Gg, Gs^Vh, Gg, Gg, Gg, Gg, Gg^Eff, Gg^Eff, Rb^Gvs, Rb^Gvs, Rb^Gvs, Rb^Gvs, Rb^Gvs, Rb^Gvs, Rb^Gvs, Rb^Gvs, Rb^Gvs, Rb^Gvs, Gg^Eff, Gg^Eff, Gg, Gg, Rr, Rr, Rr, Gll^Fmf, Gll^Fmf, Gll^Fmf, Gll^Fmf, Gg
Gg, Gg, Gg, Gg, Gg, Gg, Gg, Gg, Gg, Gg^Eff, Rb^Gvs, Rb^Gvs, Rb^Gvs, Rb^Gvs, Rb^Gvs, Rb^Gvs, Rb^Gvs, Rb^Gvs, Rb^Gvs, Rb^Gvs, Gg^Eff, Gg^Eff, Gg, Gg, Gg, Gg^Efm, Rr, Rr, Rr, Gll, Gll^Fmf, Gll^Fmf, Gll^Fmf, Gg
Gg, Gg, Gg, Gg, Gg, Gg, Gg, Gg, Gg^Eff, Rb, Rb, Rb^Gvs, Rb^Gvs, Rb^Gvs, Rb^Gvs, Rb^Gvs, Rb^Gvs, Rb^Gvs, Gg^Eff, Gg^Eff, Gg, Gg, Gg, Gg, Gg, Gg, Rr, Rr, Rr, Gll^Fmf, Gll^Fmf, Gll^Fmf, Gll^Fmf, Gg
Re, Gg, Gg, Gg, Gg, Gg, Re, Gg, Gg, Gg^Eff, Gg^Eff, Rb^Gvs, Rb^Gvs, Rb^Gvs, Rb^Gvs, Rb^Gvs, Gg^Eff, Gg^Eff, Gg, Gg, Gg, Gg, Gg, Gs^Vh, Gg, Gg, Rr, Rr, Rr, Gll^Fmf, Gll^Fmf, Gll^Fmf, Gll^Fmf, Gg
Wo, Re, Re, Gg, Gg, Re, Re, Re, Re, Gg, Gg, Gg^Eff, Gg^Eff, Rb^Gvs, Gg^Eff, Gg^Eff, Gg, Gg, Sm, Gg, Gg, Gg, Gg, Gg, Gg, Gg^Efm, Rr, Rr, Rr, Gll^Fmf, Gll^Fmf, Gll^Fmf, Gll^Fmf, Gg
Wo, Wo, Ww^Ewf, Re, Re, Re, Re, Re, Re, Gg, Gg, Gg, Gg, Gg, Gg, Gg, Sm, Sm, Ww^Wkf, Sm, Sm, Gg, Gg, Gg, Gg, Gg^Efm, Rr, Rr, Rr, Gll^Fmf, Gll^Fmf, Gll^Fmf, Gll^Fmf, Gg
Wo, Wo, Wo, Wo, Wwr, Re, Re, Re, Re, Gg, Gg, Gg, Gg, Gg, Rb, Sm, Ss, Ss, Ww^Wkf, Ss, Ss, Sm, Sm, Gg, Gg, Gg^Efm, Rr, Rr, Rr, Rr, Gll^Fmf, Gll^Fmf, Gll^Fmf, Gg
Wo, Wo, Wo, Wo, Wwr, Re, Re, Re, Ww^Ewl, Re, Re, Gg, Re, Gg, Rb, Sm^Em, Ss, Ss, Ww^Wkf, Ss, Ss, Sm^Em, Sm, Rb, Gg, Gg, Re, Rr, Rr, Rr, Gll, Gll^Fmf, Gll, Gg
Wo, Wo, Wo, Ww, Wwf, Wwf, Wwf, Wwr, Ww, Ww, Wo, Re, Ww, Re, Rb, Ss, Ss, Ss, Ww^Wkf, Ss, Ss, Ss, Sm, Rb, Re, Gg, Re, Rr, Rr, Rr, Wwr, Ww^Ewf, Ww, Rb
Wo, Wo, Ww, Ww, Wwf, Wwf, Wwf, Wwr, Wo, Wo, Wo, Wo, Wo, Wo, Wo, Ww, Ww, Ww^Wkf, Ww^Wkf, Ww^Wkf, Ww, Ww^Ewl, Ww, Rb, Ww, Re, Re, Rr, Rr, Wwr, Wwr, Ww, Wo, Wo
Wo, Ww, Ww^Ewl, Ww, Wwf, Wwf, Wwf, Ww, Wo, Wo, Wo, Wo, Wo, Wo, Wo, Wo, Wo, Ww, Wo, Ww, Wo, Wo, Wo, Wo, Wo, Ww, Ww, Wwr, Wwf, Wwf, Ww, Wo, Wo, Wo
Rb, Rb, Rb, Wwr, Rb, Wwf, Wwr, Ww, Wo, Wo, Wo, Wo, Wo, Wo, Wo, Wo, Wo, Wo, Wo, Wo, Wo, Wo, Wo, Wo, Wo, Wo, Wo, Ww, Wwf, Wwf, Ww, Wo, Wo, Wo
Gg, Rb, Gs^Vc, Rb, Re, Wwf, Wwr, Ww, Ww^Ewl, Wo, Wo, Wo, Ww, Wo, Ww, Wo, Wo, Wo, Wo, Wo, Wo, Wo, Wo, Wo, Wo, Wo, Wo, Ww, Wwf, Wwf, Ww, Wo, Wo, Wo
Gg, Rb, Gg^Efm, Re, Re, Re, Rb, Wwr, Rb, Rb, Ss, Ww, Ss, Ss, Ss, Ww, Ss, Ww, Ww, Ww, Rb, Ww, Rb, Ww, Ww, Wo, Ww^Ewf, Ww, Wwf, Wwf, Wwr, Ww, Wwr, Wo
Gll^Fmf, Gg, Gg, Re, Gs, Re, Re, Rb, Rb, Sm, Ss, Ss, Ss, Ss, Ww^Ewl, Ss, Ss, Ss, Sm, Rb, Rb, Rb, Rb, Rb, Rb, Rb, Rb, Wwr, Rr, Rr, Rr, Rb, Rb, Rb
Gll^Fmf, Gll^Fmf, Gll, Gs, Gs, Gs, Re, Re, Rb, Sm, Ss, Ss, Ss, Ww, Ss, Ss, Ss, Ss, Sm, Sm, Sm, Rb, Rb, Rb, Re, Re, Re, Rb, Rr, Rr, Rr, Re, Re, Re
Gll^Fmf, Gll^Fmf, Gll, Gs, Gs, Gs, Re, Re, Rb, Sm, Sm, Ss, Ss, Ww^Wkf, Ss, Ss, Sm, Sm, Sm, Sm, Sm, Sm, Rb, Rb, Re, Re, Re^Es, Re, Re^Es, Rr, Rr, Rr, Re, Re
Gll^Fmf, Gll^Fmf, Gll, Gs, Gs, Gs, Re, Rb, Rb, Sm, Sm^Em, Sm, Sm, Ww^Wkf, Sm, Sm, Sm, Sm, Ss, Sm, Sm, Sm, Sm, Rb, Re, Re, Re, Re, Re, Rr, Rr, Rr, Gll^Fp, Gll^Fp
Gll^Fmf, Gll^Fmf, Gll^Fmf, Gs, Gs, Gs, Re, Re, Rb, Sm, Sm, Sm, Sm, Ww^Wkf, Ww^Wkf, Sm, Ss, Ss, Ss, Ss, Ss, Sm, Sm, Rb, Re, Re, Gg^Gvs, Gg, Gg, Rr, Rr, Rr, Gll^Fp, Gll^Fp
Gll^Fmf, Gll^Fmf, Gll^Fmf, Gs, Gs, Gs, Re, Re^Es, Rb, Sm, Sm, Sm^Em, Ss, Sm, Sm, Ww^Wkf, Ss, Ss, Ss, Ss, Ss, Sm, Sm, Rb, Gg, Gg^Gvs, Gg^Gvs, Gg^Gvs, Gg^Gvs, Rr, Rr, Rr, Gll^Fp, Gll^Fp
Gll^Fmf, Gll^Fmf, Gll^Fmf, Re, Gs, Gs, Gs, Re, Rb, Sm, Sm, Ss, Ss, Ss, Sm, Ww^Wkf, Ss, Ss, Ss, Ss, Ss, Sm, Rb, Rb, Gg, Gg^Gvs, Gg, Gg^Gvs, Gg, Rr, Rr, Rr, Gll^Fp, Gll^Fp
Gll^Fmf, Gll^Fmf, Gll^Fmf, Re, Gs, Gs, Gs, Re, Rb, Sm, Sm, Ss, Ss, Ss, Ss, Ww^Wkf, Ss, Ss, Ss, Ss, Ss, Sm, Sm, Rb, Gg^Efm, Gg, Gs^Vc, Gg, Gg^Efm, Rr, Rr, Rr, Gll^Fp, Gll^Fp
Gll^Fmf, Gll^Fmf, Gll, Re, Gs, Gs, Gs, Re, Rb, Rb, Sm, Sm, Ss, Ss, Ss, Ww^Wkf, Ss, Ss, Ss, Ss, Ss, Sm, Sm, Rb, Gg, Gg, Gll^Fp, Gg, Gg^Efm, Rr, Rr, Rr, Gll^Fp, Gll^Fp
Gll^Fmf, Gll^Fmf, Gll, Re, Gs, Gs, Gs, Re, Rb, Rb, Rb, Sm, Sm, Ss, Ss, Ss, Ss, Ss, Ss, Ss, Sm, Sm, Sm, Rb, Gll^Fp, Gll^Fp, Gll^Fp, Gg, Re, Rr, Rr, Rr, Rr, Gll^Fp
Gll^Fmf, Gll^Fmf, Gll^Fmf, Re, Re, Gs, Re, Re, Re, Rb, Rb^Es, Rb, Sm, Ss, Ss, Ss, Ss, Ss, Sm^Em, Sm, Sm, Sm, Rb, Rb, Gll^Fp, Gll^Fp, Gg, Re, Re^Es, Re, Rr, Rr, Rr, Rr
Gll^Fmf, Gll^Fmf, Gll^Fmf, Gll, Gll, Re, Re, Re, Re, Rb, Rb, Rb, Sm, Ss, Ss, Ss, Ss, Ss, Sm, Sm, Sm, Sm, Rb, Gg, Gll^Fp, Gll^Fp, Gg, Re, Re, Re, Re, Rr, Rr, Rr
Gll^Fmf, Gll^Fmf, Gll^Fmf, Gll, Gll, Cer, Cer, Re, Re, Re, Rb, Rb, Rb, Ss, Ss, Ss, Ss, Ss, Sm, Sm, Rb, Rb, Gll^Fp, Gll^Fp, Re, Re, Re, Re, Re, Re, Re, Re, Hh, Hh
Gll^Fmf, Gll^Fmf, Gll^Fmf, Gll, Gll, Ker, Re, Re, Re, Re^Es, Re, Rb, Rb, Rb, Sm, Ss, Sm, Sm, Hh, Rb, Re, Gll^Fp, Re, Re, Re^Es, Re, Re, Re, Ce, Ce, Hh, Hh, Hh, Hh
Gll, Gll^Fmf, Gll, Gll, Gll, Gs, Re, Re^Es, Re, Re, Re, Re, Re, Rb, Hh, Sm, Hh, Hh, Mm, Hh, Hh, Re, Re, Re^Es, Re, Re, Ce, Ce, 2 Ke, Ce, Hh, Hh, Mm, Hh
Gll, Gll, Gll, Gll, Hh, Hh, Hh, Re, Re, Re, Re, Re, Hh, Hh, Mm, Hh, Mm, Hh, Hh, Mm, Mm, Hh, Hh, Re, Re^Vct, Hh, Hh, Ce, Hh, Hh, Mm, Mm, Mm, Mm
Hh, Hh, Mm, Hh, Mm, Hh, Mm, Hh, Hh, Re^Vct, Hh, Hh, Hh, Hh, Mm, Mm, Mm, Mm, Hh, Mm, Mm, Mm, Mm, Hh, Hh, Hh, Hh, Hh, Mm, Hh, Mm, Mm, Mm, Mm
Hh, Mm, Mm, Mm, Mm, Mm, Mm, Mm, Hh, Hh, Hh, Hh, Mm, Hh, Mm, Mm, Mm, Hh, Mm, Mm, Mm, Mm, Mm, Mm, Hh, Hh, Mm, Mm, Mm, Mm, Mm, Mm, Mm, Mm
Gg, Mm, Gg, Mm, Gg, Mm, Gg, Hh, Gg, Hh, Gg, Mm, Gg, Mm, Gg, Mm, Mm, Mm, Gg, Mm, Gg, Mm, Gg, Mm, Gg, Hh, Gg, Mm, Gg, Mm, Gg, Mm, Gg, Mm
